*      *      +     *      *      *
*      |      *     +      *      +
*      *      *     |      *      *
*      |      *     *      *      |
*      *      |     +      *      *
*      |      *     *      +      *