*  *  *  *  *  +
|  *  |  |  *  *
|  *  *  |  |  *
*  *  |  *  *  |
*  |  |  |  *  *
*  *  *  *  *  *