*  |  *  *  *  *
*  +  *  +  *  *
*  |  *  *  *  *
*  *  |  *  *  *
*  *  +  *  *  *
|  *  *  *  *  *